wwwwwwwwwwwwwwwwwwwwwwwwwwwwwwwwwwwwwwwwwwwwwwwwwwww
wx-wc------A----x--------wwx-w---------------------w
w--w------------------x------w----------------------
w--w----t----------------ww--w----t----------------w
w-x------t------x-------bww-x------t------x-------bw
w--w-----t----------wwwwwww--w-----t----------wwwwww
w--w--------wwwww--------ww--w--------wwwww--------w
w--w---t----wx--w-----x--ww--w---t--------w--------w
w--x-----wwww---w-w------wwwwwwwwwwwwwwwxwwwwwwwwwww
w--------w--------w------ww--------w--------w------w
w---c----w--------w-x----ww--------w--------w-x----w
w---x-------b-----w-----cww---x-------b-----w-----cw
wx-wc-----------x--------wwx-wc-----------x--------w
w--w---------c--------x--ww--w------------------x--w
w--w----t----------------ww--w----t----------------w
w-x------t------x--------ww-x------t------x--------w
w--w-----t----------wwwwwww--w-----t----------wwwwww
w--w--------wwwww--------ww--w--------wwwww--------w
w--w---t----wx--w-----x--ww--w---t----wx--w-----x--w
w--c--c--wwww---w-w------ww--c-----wwww---w-w------w
w--------w--------w------ww--------w--------w------w
w--------w--------w-x----ww--------w--------w-x----w
w---x------x------w-----cww---x------e------w-----cw
wwwwwwwwwwwwwwwwwwwwwwwwwwwwwwwwwwwwwwwwwwwwwwwwwwww